11111111111111111111111111
10C000011111111110000C0001
10000000111111110000000001
11111000001110000000111111
11110000000E00000000011111
11100000000100000000000111
11C10001111111110000001C11
10000001111111110000000001
10000001111111110000000001
10000000000000000000000001
10000000000P00000000000001
11111111111111111111111111